;ReplaceName
;記述したアイテム名を変更します。
;書式(元アイテム名=変更アイテム名)

[Replace]
こんぼう=Club
長巻=Nagamaki
カタナ=Katana
ドラゴンキラー=Dragon Killer
どうたぬき=Dotanuki
剛剣マンジカブラ=Kabura's Blade
成仏のカマ=Ghost Sickle
つるはし=Pickaxe
サトリのつるはし=Wonder Pick
必中の剣=Homing Blade
ミノタウロスの斧=Minotaur's Axe
妖刀かまいたち=Razor Wind
1ツ目殺し=Cyclops Killer
ドレインバスター=Drain Buster
火迅風魔刀=Fiery Fuuma
秘剣カブラステギ=Kaburasutegi
にぎりへんげの剣=Onigiri Sword
ケンゴウのカタナ=Kengo's Katana
使い捨ての剣=Shoddy Sword
ぶっとびハンマー=Blast Hammer
龍神剣=Ryujin Sword
ヤリ=Spear
アイアンヘッドの頭=Ironhead's Head
三日月刀=Crescent Arm
モーニングスター=Morning Star
如意棒=Power Pole
ガマラのムチ=Froggo Whip
金の剣=Gold Sword
鍛えた木刀=Wooden Sword
回復の剣=Healing Sword
マリンスラッシャー=Marine Slasher
車輪のやいば=Bladed Wheel
天神楽ノ剣=Amano Kagura
背水の剣=Crisis Sword
根性の竹刀=Bamboo Sword
衰弱の枝=Sapping Branch
鉄扇=Tessen
黄泉水底ノ鎖=Yomino Minasoko
木づち=Mallet
かつおぶし=Dried Bonito

皮の盾=Leather Shield
青銅甲の盾=Bronze Shield
鍛えた木の盾=Wooden Shield
鉄甲の盾=Iron Shield
ドラゴンシールド=Dragon Shield
風魔の盾=Fuuma Shield
バトルカウンター=Counter Shield
重装の盾=Heavy Shield
やまびこの盾=Echo Shield
見切りの盾=Spry Shield
みやびやかな盾=Elegant Shield
獣王の盾=Beast Shield
使い捨ての盾=Shoddy Shield
地雷ナバリの盾=Blast Shield
トドの盾=Walrus Shield
ラセン風魔の盾=Helix Shield
矛の盾=Halberd Shield
サトリの盾=Nirvana Shield
身かわしの盾=Dodge Shield
ガマラの盾=Froggo Shield
しあわせの盾=Happy Shield
うろこの盾=Scale Shield
金の盾=Gold Shield
おまつりの盾=Festive Shield
不動の盾=Steady Shield
星神輿の盾=Hoshino Mikoshi
ゴムバンの盾=Rubber Shield
グランドカウンター=Grand Counter
正面戦士の盾=Frontal Shield
黄泉巫女神ノ盾=Yomino Mikogami
どんぶりの盾=Bowl Shield

通過の腕輪=Float Bracelet
値切の腕輪=Bargain Bracelet
サビよけの腕輪=No-Rust Bracelet
会心の腕輪=Critical Bracelet
痛恨の腕輪=Regret Bracelet
呪いよけの腕輪=Holy Bracelet
遠投の腕輪=Pierce Bracelet
しあわせの腕輪=Happy Bracelet
透視の腕輪=Scout Bracelet
混乱よけの腕輪=Calm Bracelet
ハラヘラズの腕輪=Nirvana Bracelet
ハラヘリの腕輪=Hunger Bracelet
識別の腕輪=Identify Bracelet
まがりの腕輪=Bend Bracelet
百発百中の腕輪=Bullseye Bracelet
ちからの腕輪=Strength Bracelet
うけながしの腕輪=Parry Bracelet
いやしの腕輪=Heal Bracelet
とうぞくの腕輪=Thief Bracelet
まもりの腕輪=Protect Bracelet
ねむらずの腕輪=Alert Bracelet
ワナ師の腕輪=Trapper Bracelet
パコレプキンの腕輪=Phantasm Bracelet
必着の腕輪=Bind Bracelet
たかとびの腕輪=Warp Bracelet
よくみえの腕輪=Vision Bracelet
ドレインよけの腕輪=No-Drain Bracelet
身代わりの腕輪=Decoy Bracelet
ねがいの腕輪=Wish Bracelet
気力の腕輪=Spirit Bracelet

木の矢=Wood Arrow
鉄の矢=Iron Arrow
銀の矢=Silver Arrow
会心の矢=Critical Arrow
かまいたちの矢=Razor Arrow
毒矢=Poison Arrow
デブータの石=Porky Rock
大砲の弾=Cannonball

おにぎり=Onigiri
大きなおにぎり=Large Onigiri
巨大なおにぎり=Huge Onigiri
まずそうなおにぎり=Spoiled Onigiri
特製おにぎり=Special Onigiri
コヨリのおにぎり=Koyori's Onigiri
奇妙なおにぎり=Strange Onigiri
焼きおにぎり=Grilled Onigiri
黒焦げおにぎり=Charred Onigiri

薬草=Herb
弟切草=Otogiriso
めぐすり草=Sight Grass
ドラゴン草=Dragon Grass
無敵草=Invincible Grass
復活の草=Revival Grass
命の草=Life Grass
胃拡張の種=Expand Seed
胃縮小の種=Shrink Seed
しあわせ草=Happy Grass
天使の種=Angel Seed
くねくね草=Twisty Grass
不幸の種=Unlucky Seed
超不幸の種=Disaster Seed
毒消し草=Antidote Grass
ちからの種=Strength Seed
毒草=Poison Grass
混乱草=Dizzy Grass
睡眠草=Sleep Grass
高とび草=Warp Grass
すばやさの種=Swift Seed
雑草=Weeds
キグニ族の種=Kigny Seed
よくきき草=Boost Grass
火炎草=Flame Grass
物忘れの草=Amnesia Grass

識別の巻物=Identify Scroll
あかりの巻物=Navigation Scroll
壺増大の巻物=Pot Expand Scroll
奥技の巻物=Skill Scroll
困った時の巻物=Fixer Scroll
バクスイの巻物=Slumber Scroll
大部屋の巻物=Great Hall Scroll
モンスターハウスの巻物=Mon House Scroll
混乱の巻物=Confusion Scroll
ねだやしの巻物=Extinction Scroll
すいだしの巻物=Suction Scroll
おはらいの巻物=Purify Scroll
天の恵みの巻物=Heaven Scroll
地の恵みの巻物=Earth Scroll
メッキの巻物=Plating Scroll
ワナの巻物=Trap Scroll
引き上げの巻物=Retreat Scroll
炎上の巻物=Blaze Scroll
ゾワゾワの巻物=Fear Scroll
壺われずの巻物=Sturdy Pot Scroll
水がれの巻物=Desert Scroll
飛ばずの巻物=Gravity Scroll
はりつけの巻物=Pin Scroll
聖域の巻物=Sanctuary Scroll
白紙の巻物=Blank Scroll
持ち帰りの巻物=Escape Scroll
水びたしの巻物=Puddle Scroll
ファイトの巻物=Cheer Scroll
落石の巻物=Rockfall Scroll
いかずちの巻物=Lightning Scroll
ワナけしの巻物=Trap Erase Scroll
必中の巻物=Accuracy Scroll
困った巻物=Trouble Scroll
火種の巻物=Burn Scroll
転写の巻物=Copy Scroll
ぬれた巻物=Wet Scroll

会心剣の秘技書=Crit Scroll
神速剣の秘技書=Quick Scroll
必中剣の秘技書=Precise Scroll
必殺剣の秘技書=Fatal Scroll
四方剣の秘技書=Cross Scroll
八方剣の秘技書=Circle Scroll
雷神剣の秘技書=Elec. Scroll
居合斬りの秘技書=Disarm Scroll
兜割りの秘技書=Helm Scroll
龍斬りの秘技書=Dragon Scroll
黄泉送りの秘技書=Ghost Scroll
爆斬剣の秘技書=Bomb Scroll
目激の秘技書=Cyclops Scroll
水妖斬の秘技書=Aquatic Scroll
吸散の秘技書=Drain Scroll
気攻弾の秘技書=Bullet Scroll
気攻裂波の秘技書=Wave Scroll
貫通裂波の秘技書=P.Wave Scroll
交錯の秘技書=Swap Scroll
裏当て身の秘技書=Swap S. Scroll
通背剣の秘技書=Line S. Scroll
鬼月の秘技書=Lunge Scroll
体当の秘技書=Tackle Scroll
気合投げの秘技書=S.Throw Scroll
八方投げの秘技書=C.Throw Scroll
受け返しの秘技書=Counter Scroll
強弓の秘技書=P.Bow Scroll
軟投の秘技書=Pitch Scroll
強肩の秘技書=S.Toss Scroll
遠投の秘技書=P.Toss Scroll
暇投げの秘技書=H.Toss Scroll
一気投げの秘技書=Mass Toss
銭投げの秘技書=Gitan Scroll
小判投げの秘技書=Coin Scroll
大判投げの秘技書=B.Coin Scroll
目潰の秘技書=Blind Scroll
猫だましの秘技書=Cat Scroll
虎だましの秘技書=Tiger Scroll
合歓掌の秘技書=Silk Scroll
春眠香の秘技書=Slumber Scroll
呪詛の秘技書=Curse Scroll
呪縛の秘技書=B.Curse Scroll
轟天雷の秘技書=Thunder Scroll
大崩落の秘技書=Rock Scroll
懐盗の秘技書=Steal Scroll
四股の秘技書=Stamp Scroll
発火の秘技書=Ignite Scroll
鬼火の秘技書=Wisp Scroll
火神の秘技書=Flame Scroll
水浸の秘技書=Flood Scroll
高飛びの秘技書=Flee Scroll
水蜘蛛の秘技書=Strider Scroll
罠外しの秘技書=B.Trap Scroll
岩石割りの秘技書=R.Break Scroll
岩石崩しの秘技書=R.Crush Scroll
値切の秘技書=Barter Scroll
深呼吸の秘技書=Breathe Scroll
超代謝の秘技書=Super Scroll
毒抜きの秘技書=Detox Scroll
復帰の秘技書=Recover Scroll
解呪の秘技書=Purify Scroll
霞飯の秘技書=Meal Scroll
一気食いの秘技書=Binge Scroll
活目の秘技書=Sight Scroll
識別の秘技書=Assess Scroll
乱舞の秘技書=Dance Scroll
瞬足の秘技書=Swift Scroll
トド守りの秘技書=Walrus Scroll
不眠の秘技書=Alert Scroll
心頭滅却の秘技書=Zen Scroll
爆弾無効の秘技書=N.Blast Scroll
雷無効の秘技書=N.Light Scroll
身かわしの秘技書=Dodge Scroll
見切りの秘技書=Agile Scroll
跳返の秘技書=Rebound Scroll
結界の秘技書=Barrier Scroll
無敵の秘技書=Steel Scroll
死門の秘技書=Death Scroll

ふきとばしの杖=Knockback Staff
しあわせの杖=Happy Staff
不幸の杖=Unlucky Staff
身がわりの杖=Decoy Staff
場所替えの杖=Swap Staff
かなしばりの杖=Paralysis Staff
一時しのぎの杖=Transient Staff
痛み分けの杖=Empathy Staff
封印の杖=Seal Staff
鈍足の杖=Slow Staff
とうめいの杖=Invisible Staff
倍速の杖=Swift Staff
引きよせの杖=Pull Staff
火ばしらの杖=Fire Staff
いかずちの杖=Lightning Staff
回復の杖=Heal Staff
トンネルの杖=Tunnel Staff
からぶりの杖=Miss Staff
けものみちの杖=Monster Staff
転ばぬ先の杖=Balance Staff
ばくだんの杖=Bomb Staff
入れ替えの杖=Exchange Staff
クォーターの杖=Quarter Staff
イカリの杖=Rage Staff
オオイカリの杖=Fury Staff

保存の壺=Storage Pot
やりすごしの壺=Hide Pot
強化の壺=Upgrade Pot
識別の壺=Identify Pot
回復の壺=Heal Pot
弱化の壺=Degrade Pot
底抜けの壺=Black Hole Pot
倉庫の壺=Mailing Pot
変化の壺=Presto Pot
合成の壺=Synthesis Pot
手封じの壺=Sticky Pot
水がめ=Water Pot
換金の壺=Sale Pot
祝福の壺=Blessing Pot
呪いの壺=Curse Pot

番犬の箱=Guard Dog
盗賊番の箱=Sheriff
ガマラの箱=Froggo
ガマグッチの箱=Froggucci
ガマゴンの箱=Froggon
くねくねハニーの箱=Twisty Hani
ゲイズの箱=Gazer
スーパーゲイズの箱=Super Gazer
ハイパーゲイズの箱=Hyper Gazer
シューベルの箱=Schubell
メンベルスの箱=Menbell
ベルトーベンの箱=Bellthoven
タウロスの箱=Taur
ミノタウロスの箱=Minotaur
メガタウロスの箱=Megataur
デブータの箱=Porky
デブーチョの箱=Porko
デブートンの箱=Porkon
ドラゴンの箱=Dragon
スカイドラゴンの箱=Sky Dragon
アークドラゴンの箱=Archdragon
ぬすっトドの箱=Zalokleft
みどりトドの箱=Lime Zalokleft
アイアントドの箱=Iron Zalokleft
パコレプキンの箱=Pumphantasm
パコレプキーナの箱=Pumphantom
パコレプキングの箱=Pumpanshee
ボウヤーの箱=Bow Boy
コドモ戦車の箱=Boy Cart
オヤジ戦車の箱=Pop Tank
イッテツ戦車の箱=Cranky Tank
マムルの箱=Mamel
あなぐらマムルの箱=Pit Mamel
洞窟マムルの箱=Cave Mamel
しろがねマムルの箱=Silver Mamel
おうごんマムルの箱=Gold Mamel
にぎりみならいの箱=Nigiri Novice
にぎりへんげの箱=Nigiri Morph
にぎり親方の箱=Nigiri Boss
にぎりもとじめの箱=Nigiri Master
ンドゥバの箱=N'dubba
エーテルデビルの箱=Ether Devil
ファントムデビルの箱=Phantom Devil
ミラージュデビルの箱=Mirage Devil
アストラルデビルの箱=Astral Devil
おばけ大根の箱=Mutaikon
めまわし大根の箱=Dazikon
ねむり大根の箱=Dozikon
火炎入道の箱=Inferno
キグニ族の箱=Kigny
鬼面武者の箱=Demon Warrior
はんにゃ武者の箱=Hannya Warrior
将軍の箱=Shogun
ぼうれい武者の箱=Ghost Warrior
とおせんりゅうの箱=Floor Dragon
ドラゴンヘッドの箱=Dragon Head
スルードラゴンの箱=Tunnel Dragon
ノロージョの箱=Curse Girl
ノロージョの姉の箱=Curse Sister
ノロージョの母の箱=Curse Mom
兵隊アリの箱=Soldier Ant
隊長アリの箱=Captain Ant
将軍アリの箱=General Ant
わらうポリゴンの箱=Laugh Polygon
まわるポリゴンの箱=Spin Polygon
おどるポリゴンの箱=Dance Polygon
うたうポリゴンの箱=Sing Polygon
ミドロの箱=Slime
ゲドロの箱=Grime
オドロの箱=Ooze
ドドロの箱=Sludge
チンタラの箱=Chintala
ちゅうチンタラの箱=Mid Chintala
おおチンタラの箱=Big Chintala
カラス天狗の箱=Crow Tengu
ハヤブサ天狗の箱=Falcon Tengu
イヌワシ天狗の箱=Eagle Tengu
ダイキライの箱=Bomb
エレーキライの箱=Elec Bomb
チョーキライの箱=Fire Bomb
ロケットイノシシの箱=Rocket Boar
ジェットイノシシの箱=Jet Boar
ソニックイノシシの箱=Sonic Boar
ひまガッパの箱=Bored Kappa
いやすぎガッパの箱=Kappa Pest
たまらんガッパの箱=Vexing Kappa
馬武者の箱=Horse Ronin
荒馬ザムライの箱=Horse Samurai
あばれ馬将軍の箱=Horse Shogun
乱れ馬王の箱=Horse Emperor
パ王の箱=King Tusker
パオパ王の箱=Monarch Tusker
パオパ王ーンの箱=Emperor Tusker
バットカンガルーの箱=Bat Kangaroo
エビルカンガルーの箱=Evil Kangaroo
デビルカンガルーの箱=Devil Kangaroo
タイガーウッホの箱=Tiger Tosser
タイガーウホホの箱=Tiger Hurler
タイガーウホーンの箱=Tiger Chucker
しおいやんの箱=Sluggy
まじしおいやんの箱=Bitter Sluggy
しおやだんの箱=Rancor Sluggy
しおかんべんの箱=Venom Sluggy
ケンゴウの箱=Kengo
イアイの箱=Iai
シハンの箱=Shihan
シャーガの箱=Shagga
ナシャーガの箱=Nashagga
ラシャーガの箱=Lashagga
オトト兵の箱=Spearfish
オトト軍曹の箱=Lt.Spearfish
オトト大将の箱=Capt.Spearfish
オトト元帥の箱=Adm.Spearfish
プチフェニックスの箱=Tiny Phoenix
ボーンドラゴンの箱=Bone Dragon
スカルドラゴンの箱=Skull Dragon
ガルムドラゴンの箱=Garm Dragon
アイアンヘッドの箱=Ironhead
チェインヘッドの箱=Chainhead
ギガヘッドの箱=Gigahead
ムーロンの箱=Muron
イェンロンの箱=Yenron
シンロンの箱=Shenron
ジャガン仮面の箱=Jagan Mask
ジャガー王子の箱=Jagar Prince
ジャガール王の箱=Jagar King
プルンの箱=Pud
プルリンの箱=Pudding
プルンプリンの箱=Custard
うしわか丸の箱=Lady Locks
クロウ丸の箱=Lovely Locks
ヨシツネ丸の箱=Goldie Locks
怪盗ペリカンの箱=Thief Pelican
怪盗ペリカン２世の箱=Robber Pelican
怪盗ペリカン３世の箱=Bandit Pelican
怪盗ペリカン４世の箱=Raider Pelican
よせカエルの箱=Tug Frog
すぐカエルの箱=Pull Frog
いまカエルの箱=Yank Frog
影ぼうしの箱=Shadow Hat
黒ぼうしの箱=Black Hat
闇ぼうしの箱=Dark Hat
とげドラゴンの箱=Spike Dragon
アースニードルの箱=Earth Needle
サンダーランスの箱=Thunder Lance

ドラゴン回路=Dragon Circuit
一ツ目回路=Cyclops Circuit
成仏回路=Ghost Circuit
ドレイン回路=Drain Circuit
三日月回路=Crescent Circuit
必中回路=Accuracy Circuit
会心回路=Critical Circuit
倍速回路=Swift Circuit
HP回路=HP Circuit
ちから回路=Strength Circuit
まもり回路=Protect Circuit
見切り回路=Evasion Circuit
炎よけ回路=Cold Circuit
地雷ナバリ回路=Blast Circuit
魔法よけ回路=No-Magic Circuit
身かわし回路=Dodge Circuit
やまびこ回路=Echo Circuit
はね返し回路=Reflect Circuit
不動回路=Steady Circuit
しあわせ回路=Happy Circuit
復活回路=Revival Circuit
使用済み回路=Used Circuit

ギタン= Gitan
風魔石=Fuuma Stone
ンドゥバ=N'dubba

鈍足のワナ=Slow Trap
ケロケロの雨=Rust Trap
落石のワナ=Rockfall Trap
大落石のワナ=Rockslide Trap
バネ=Spring
トラバサミ=Bear Trap
一方通行のワナ=One-Way Trap
イガイガボトボト=Burr Trap
転び石=Trip Stone
モンスターのワナ=Monster Trap
警報スイッチ=Alert Trap
罠のワナ=Multiply Trap
眠りガス=Sleep Trap
幻覚ガス=Illusion Gas
回転板=Spin Trap
連鎖のワナ=Chain Trap
木の矢のワナ=Wood Arrow Trap
鉄の矢のワナ=Iron Arrow Trap
毒矢のワナ=Poison Arrow Trap
落し穴=Pitfall
召喚スイッチ=Summon Trap
地雷=Landmine
大型地雷=Big Landmine
デロデロの湯=Spoil Trap
装備外しのワナ=Strip Trap
水滴ポットン=Droplet Trap
丸太のワナ=Log Trap
トゲのワナ=Spike Trap
呪いのワナ=Curse Trap
イカリのワナ=Rage Trap
いかずちのワナ=Zap Trap
